+------------+ +------------+
|            | |            |
| +--+ +---+ | | +---+ +--+ |
| |  | |   | | | |   | |  | |
| +--+ +---+ +-+ +---+ +--+ |
|                           |
| +--+ ++ +-------+ ++ +--+ |
| +--+ || +--+ +--+ || +--+ |
|      ||    | |    ||      |
+----+ |+--+ | | +--+| +----+
     | |+--+ +-+ +--+| |
     | ||           || |
     | || +--===--+ || |
-----+ ++ |       | ++ +-----
          |       |
-----+ ++ |       | ++ +-----
     | || +-------+ || |
     | ||           || |
     | || +-------+ || |
+----+ ++ +--+ +--+ ++ +----+
|            | |            |
| +--+ +---+ | | +---+ +--+ |
| +-+| +---+ +-+ +---+ |+-+ |
|   ||                 ||   |
+-+ || ++ +-------+ ++ || +-+
+-+ ++ || +--+ +--+ || ++ +-+
|      ||    | |    ||      |
| +----++--+ | | +--++----+ |
| +--------+ +-+ +--------+ |
|                           |
+---------------------------+