+------------+ +------------+
|............| |............|
|.+--+.+---+.| |.+---+.+--+.|
|o|  |.|   |.| |.|   |.|  |o|
|.+--+.+---+.+-+.+---+.+--+.|
|...........................|
|.+--+.++.+-------+.++.+--+.|
|.+--+.||.+--+ +--+.||.+--+.|
|......||....| |....||......|
+----+.|+--+ | | +--+|.+----+
     |.|+--+ +-+ +--+|.|
     |.||...........||.|
     |.||.+--===--+.||.|
-----+.++.|       |.++.+-----
         .|       |.
-----+.++.|       |.++.+-----
     |.||.+-------+.||.|
     |.||..... .....||.|
     |.||.+-------+.||.|
+----+.++.+--+ +--+.++.+----+
|............| |............|
|.+--+.+---+ | |.+---+.+--+.|
|.+-+|.+---+ +-+.+---+.|+-+.|
|o..||.................||..o|
+-+.||.++.+-------+.++.||.+-+
+-+.++.||.+--+ +--+.||.++.+-+
|......||....| |....||......|
|.+----++--+.| |.+--++----+.|
|.+--------+.+-+.+--------+.|
|...........................|
+---------------------------+